amplicon	amplicon_start	amplicon_end	ampInsert_start	ampInsert_end	amplicon_length	ampInsert_length	fwd_primer	rev_primer
Pf3D7_01_v3-145416-145660-2	145416	145660	145449	145627	244	179	TTGTTCGATATGTTTAAATATATGATTCTCGAA	AATGTCCAATATGTCAAGGTATATTAAAGTATG
Pf3D7_01_v3-179866-180151-2	179866	180151	179892	180120	285	229	CGATGATATAACAACAAGCTTTGTCG	GGATCTGATACCTATAGCTTCCATATTTTCA
Pf3D7_01_v3-181528-181703-2	181528	181703	181560	181674	175	115	ATTAGCTTTTTCAAACCTTTCATTATTGTTTT	AATAAGCTTAGGCAAAAATTGGTGAAAAT
Pf3D7_01_v3-495940-496171-2	495940	496171	495970	496143	231	174	AAGCCACCAAAATATTATATACCACAAGAC	AAGGAAAATCTTTGGTGGGAAAAATAGA
Pf3D7_01_v3-500912-501201-2	500912	501201	500945	501178	289	234	AACACAAATTTGTGTAGAATGAAATATGGTAGA	GCTTATGTAGCCGTACCAGTAGA
Pf3D7_01_v3-512169-512418-2	512169	512418	512199	512388	249	190	CGAATCAAAGGTAGAAAATGATCTTGAAGA	CTGTGGATTATTTATACGATTCCTTTGACA
Pf3D7_01_v3-517527-517806-2	517527	517806	517560	517773	279	214	ATTATGATGATCAAAAATTTCAGTGGATTGATG	TCCCTTAATATGCTCATTTTATTTTCTATCAAT
Pf3D7_01_v3-529027-529276-2	529027	529276	529053	529245	249	193	AACAAAAGAGGGAAAGGAATAAAGCA	ACAAATTGTTAGTAACAACAACACATGTTTT
Pf3D7_01_v3-531657-531930-2	531657	531930	531685	531900	273	216	CTTTTTGGGCTTATTGTTTGGAAGAAAA	ACTGGATTCTTCTAATATTCTTTGCTCTCT
Pf3D7_01_v3-532660-532872-2	532660	532872	532689	532844	212	156	TGGGAAGAATGGTTTAATCGTAAAAATGA	GTCTTCGAAATAATGAACTCCCTTTTCT
Pf3D7_01_v3-533904-534192-2	533904	534192	533937	534159	288	223	GTGCACATTAATTATTCCTCCTAAATATCATAA	CACATCTGAAATATTTAAAGGTTTCAAATCTTT
Pf3D7_01_v3-534909-535147-2	534909	535147	534942	535114	238	173	TGTATGTGTGTTGATTGTAATTATAAGAATTGT	TCTTCTACAAAAATTATGAAAAAGTTTGGTTCC
Pf3D7_01_v3-535784-536038-2	535784	536038	535812	536008	254	197	AGGTGATAAAAATGAAAATTTGCACACA	ACATCATTTTTAAAATCAAACAACTGGAAA
Pf3D7_02_v3-109769-110018-2	109769	110018	109802	109988	249	187	CAACATTTCCACCATTTCTTCATTTTAATTTTG	CCTTACCATTTGGATTAAAACCTTCAGATT
Pf3D7_02_v3-278145-278369-2	278145	278369	278166	278336	224	171	CTTACCATTCGCGCTTTCTTG	AATATAGTACCAGAAAATGGAAGAATGTTAAAT
Pf3D7_02_v3-320761-321010-2	320761	321010	320786	320988	249	203	TGATCCAGGTGATATCTTTGTTCCT	CGATGGTTCACGTGTAACAACA
Pf3D7_02_v3-470460-470709-2	470460	470709	470493	470676	249	184	TGAACATGAAGAATATTGACATGAAACATTATA	GTATGTATTATACCCTCCATTTGATTATTCTCT
Pf3D7_02_v3-501366-501575-2	501366	501575	501398	501549	209	152	AAATTTAATAAAGTGACCAAATATAACGTCCA	ACCAGAGAGAATTTAAGCTTATCCCT
Pf3D7_02_v3-805796-805970-2	805796	805970	805823	805942	174	120	TTGGAAAATTTGAGAATCCTATGTGCT	TTCGATTTGCCTACAATTTGTGATTCTA
Pf3D7_02_v3-855414-855702-2	855414	855702	855447	855674	288	228	ACAAGAATGGAATTATGGATCAAATAGAAAATT	GACAACGAACAAAACTACAAAAATACCA
Pf3D7_03_v3-85402-85680-2	85402	85680	85430	85647	278	218	CCCAAGACCCATAGAAATGTTAAATGAT	TGAAGAAGTATTAAATGAAGAATTTTCAGATGC
Pf3D7_03_v3-141937-142210-2	141937	142210	141964	142180	273	217	AAAGCGAATAATGCCAATATGTTGTTC	TTTTTACAACTGACAAATTTGTTTTGTGTA
Pf3D7_03_v3-221379-221665-2	221379	221665	221406	221644	286	239	CATTAAACACACTGGAACATTTTTCCA	TATGCCAAATGACCCAAACCG
Pf3D7_03_v3-326953-327202-2	326953	327202	326981	327169	249	189	TGTGATGGTATAGAGACAACACAGTTAT	CCTCTGTTATATTATATTCACATTGTTCATCTC
Pf3D7_03_v3-573557-573797-2	573557	573797	573585	573767	240	183	TTTGCTAACTCTCATATATCCGATGTCT	ACACCATAATAATGATCATAAGGATGATCG
Pf3D7_03_v3-618368-618617-2	618368	618617	618397	618586	249	190	GGGACACTACAGACAAAAATAAATGATCT	CTGTAGAAACTCCTACTACCAATAATTTGAC
Pf3D7_03_v3-653959-654206-2	653959	654206	653989	654177	247	189	ATGTAACAAAAATTTCACCTAACGGTATAT	CTTTATGTATTTTTCAAAAATCGGCACGT
Pf3D7_03_v3-701755-701991-2	701755	701991	701788	701959	236	172	ATCACCATTCATATTATTATCTAGGTCCATTTT	ACAAACAATGATTTCTTTATACAAAACAAACA
Pf3D7_03_v3-750395-750658-2	750395	750658	750424	750628	263	205	AGGATAGTAGCAAAATGAATACTAGTGGT	AACGTTTAAATGAATTAATACCTCCACCAA
Pf3D7_03_v3-850789-851020-2	850789	851020	850817	850993	231	177	CCATTTTTATCTACACGTACTACATGCA	GCCAAATGTCTCTAAGAGTTACAGGAA
Pf3D7_03_v3-988783-989015-2	988783	989015	988812	988982	232	171	AGATTTGAAGATTTGCATATTTAGTTGGA	AGTCCACAAATAAATGATTTCTTAAATTATCCT
Pf3D7_04_v3-109879-110114-2	109879	110114	109912	110088	235	177	TTTTTAAAACTGGCAAATTATTTATTTCTGTCA	CATGAAACCGAAAACCCATTTTTCTT
Pf3D7_04_v3-128041-128219-2	128041	128219	128067	128189	178	123	CCTTTTCGTTATCTATCAATGGGCTT	TGGAAGCACTGGAAAGATTGAAAATATTAG
Pf3D7_04_v3-133464-133726-2	133464	133726	133492	133700	262	209	TTTTGGTTCAGTACTATCTCTTGCATTT	CGACACCAAATATTCAAGAAGAACCT
Pf3D7_04_v3-141731-141977-2	141731	141977	141759	141948	246	190	GACGATATATACCATGCTGATGATACAC	AAAGATCAAGCATTTGTCTGTCTATATCT
Pf3D7_04_v3-191109-191288-2	191109	191288	191141	191255	179	115	TACTCAAAATGGTGATATAAGTGCTAATCAAC	TCATAATCATCTGAGAGTTGATCAAAAATATCC
Pf3D7_04_v3-415625-415874-2	415625	415874	415657	415843	249	187	TGAATTAATAAAAGAACATGGTGGACCTTATG	AGTAACTGGATTTAAGACTTGAAAACATTTT
Pf3D7_04_v3-544687-544910-2	544687	544910	544719	544882	223	164	AACCCAGATAATCATTTATTAAATACAGACAC	TATGGAATATAAAAATCGCTAGCTGCAG
Pf3D7_04_v3-748190-748469-2	748190	748469	748221	748436	279	216	TACACATTTAGAGGTCTAGGAAATAAAGGAG	ACAATATAACATTTATCCTATTGCTTAAAGGTT
Pf3D7_04_v3-748495-748725-2	748495	748725	748528	748696	230	169	TGATGAAGATGTTTATATCATTAACAAAGTTGA	ACATCGCTAACAGAAATAATTTGATACTC
Pf3D7_04_v3-802492-802741-2	802492	802741	802523	802716	249	194	AATAAGCATCTGAACATTAAAGTTCAAACAA	CGCACATCGAATAATCTTCTTTGTG
Pf3D7_04_v3-880793-881025-2	880793	881025	880826	880993	232	168	ACATGTTACATAATCAGAATAAAAGGTTGAATC	ATTATTATTTTGCGTTTCATGTTCATAGGATA
Pf3D7_04_v3-1037603-1037868-2	1037603	1037868	1037635	1037844	265	210	ATTGAAGTACAATATGAAATCGATCTTGATAA	GTATTTGGTTTGTCAGGCAATTCG
Pf3D7_04_v3-1100630-1100863-2	1100630	1100863	1100657	1100831	233	175	CCCAAAACGGTTAATACTGAAGTTAGA	AGAAGAAGGACTTTTATAATTATCATCACCAT
Pf3D7_04_v3-1101723-1101990-2	1101723	1101990	1101749	1101958	267	210	GCAAAGAAAGCAAACGTGTAGAAATA	ACGATTTGAGTTTTACCACTTTTATCTTTTAT
Pf3D7_04_v3-1102363-1102609-2	1102363	1102609	1102390	1102581	246	192	CGTAGAGGTGTTGATGTTAATATGGAG	CTTCATCCAAACATACATCCTCTTTTTG
Pf3D7_04_v3-1113404-1113653-2	1113404	1113653	1113429	1113627	249	199	TAGATACGGTTTTCCATCCGATTCT	AGAAAATATGCTGCCACTAAACGTAG
Pf3D7_04_v3-1128462-1128705-2	1128462	1128705	1128489	1128673	243	185	CTGTCGCAAAAGAAGGTTTTGATAATA	ATGAATGAATAAATCAATTTTACCACGTCATT
Pf3D7_04_v3-1138029-1138316-2	1138029	1138316	1138061	1138283	287	223	AATACTTTTTCGGATTTTGTACTATATGTTGA	TGTATCATTCAGAAACGCTTAAATAAATATGAA
Pf3D7_05_v3-269241-269499-2	269241	269499	269264	269466	258	203	TTCTTCATAGTTGCATGGCCTTC	CCAAGGACTCATTCTCATTATTGTTTAAAATAA
Pf3D7_05_v3-329348-329581-2	329348	329581	329373	329554	233	182	CGATGTGTTAAAACAACAGGAGGAA	AGATGTTGTAGAATATTCGTGTCCGTA
Pf3D7_05_v3-565061-565310-2	565061	565310	565093	565277	249	185	TACTTTTGGATGAACATAATTTTAAAGAGCCT	TTCCCCTTATAATTAGATAAGAACAATATGGGA
Pf3D7_05_v3-832862-833110-2	832862	833110	832894	833080	248	187	GAAGAATGTTCCAATAATATAGACCAAACTCA	TCCCAAGTTAGCTACAAACATTTTATTTCT
Pf3D7_05_v3-958028-958255-2	958028	958255	958059	958222	227	164	AAATGTTTACCTGCACAACATAGAAAATTAT	TTTTGATGTAATTACATCCATACAATAACTTGA
Pf3D7_05_v3-958354-958542-2	958354	958542	958385	958510	188	126	AGATTTTTATTTAGAACAAGTGAGTTCAGGA	AATTTTACTTTCTTATTACATATGACACCACA
Pf3D7_05_v3-991301-991547-2	991301	991547	991334	991515	246	182	TCAGCCCATATCTTTTATTTACATACTAATTTG	TTCCAAATGATTTTCTCATTACTTCATATGCT
Pf3D7_05_v3-1042126-1042311-2	1042126	1042311	1042158	1042281	185	124	GAATGGAATATTTGTGATTTAGGATGTAATGC	CAAATATATCTCTTCGCATGTTTCTAAGGA
Pf3D7_05_v3-1309567-1309800-2	1309567	1309800	1309592	1309773	233	182	GTTCAATAGAAACCAACGACGAAGA	GTTTTGCAACCTCACTAAATCTTTCAT
Pf3D7_06_v3-86220-86446-2	86220	86446	86247	86422	226	176	TAAACAAACTAGTAGAACAAGGAACGC	TCCAACTTTTCATACAACATGGCA
Pf3D7_06_v3-114456-114679-2	114456	114679	114485	114647	223	163	AATTGTTGTTGTTACTATTTTTCGTGTTT	ACATAAGAATAAAGGAAATCATATGGACAACA
Pf3D7_06_v3-145315-145537-2	145315	145537	145342	145507	222	166	CCAATCAACAAAAGCTGATGAATCATC	TTTTTCCAAGGAAGGTAGAATATCAAATAC
Pf3D7_06_v3-322831-323113-2	322831	323113	322858	323081	282	224	TGTAGTGCCTGTCTAAATATCGATGAT	ACAACTTGTCTTTAACAATTCTGTTATTAGCT
Pf3D7_06_v3-532165-532411-2	532165	532411	532193	532383	246	191	ATGATCAAGCTGAATCTATCCTATTGGA	CTCATGGTATATTGTTTATTGGGATCCC
Pf3D7_06_v3-799754-799983-2	799754	799983	799787	799956	229	170	TTTGATTATGACAAGGATGAAATAAAATTACAC	ATGTGTGTACGTGATATATAAGAAGCA
Pf3D7_06_v3-1002556-1002803-2	1002556	1002803	1002584	1002776	247	193	GAGAGAAGAAAAGGAAAAGAATGATGCT	GCATTTTTGCTTCACCTAACTTTTCAC
Pf3D7_06_v3-1234427-1234629-2	1234427	1234629	1234458	1234602	202	145	AAGGATATAAATAATATGCCTCTTGAAGACT	CAATTTATGTTGTCGTCAGCATTCATT
Pf3D7_06_v3-1268127-1268382-2	1268127	1268382	1268160	1268349	255	190	GGAAACACTTAAATTATTGATTTCACATCTTCT	TGCTCAAGGATATTTAATTGTTAATAGAAATGT
Pf3D7_07_v3-80217-80463-2	80217	80463	80241	80439	246	199	TTGGTGCGATTTCTCATTTACAGT	GGCTCTCTATGTAATGGTTGGAGT
Pf3D7_07_v3-80492-80768-2	80492	80768	80515	80735	276	221	CGGCAATGCCTACTATTCCTAAG	GAATATGAAGATGCAGATGAAGATTTAACAAAA
Pf3D7_07_v3-298851-299035-2	298851	299035	298881	299007	184	127	ATCTTAGTAGATATATCATTCACAGTCGTC	TTTGTTAAGTTTTCTCTTGTGGAATCGA
Pf3D7_07_v3-465298-465576-2	465298	465576	465327	465547	278	221	AGAAACAACGAAAGAAAGAGTGAAACTAA	AAACTCACTATTCTGAACTTCCTTTGTTA
Pf3D7_07_v3-505632-505916-2	505632	505916	505661	505889	284	229	GTATTAGGGTTACCATCATTTGGAGAAAA	CCCCATGGTAAAAATATATTCGTGACT
Pf3D7_07_v3-613450-613689-2	613450	613689	613482	613662	239	181	CAAATCATTTGTGCTCTTATATTTTTATGCCT	AAAAAGCCACAAGGTAATTTGGAAATT
Pf3D7_07_v3-729944-730118-2	729944	730118	729976	730087	174	112	AATAAGAAATATGTCTTACAAGGAGATGTTTT	AAACATTATGTAGTCAACATATGAAGGAAAC
Pf3D7_07_v3-752026-752255-2	752026	752255	752059	752226	229	168	TGTAAGATTCTGTAAAGATAATTTTGCTTATGT	ACCTATTACAAGGTTTGTCATTATCGTAT
Pf3D7_07_v3-1149386-1149613-2	1149386	1149613	1149414	1149585	227	172	TCTGGACATGTAGATATTTGACTAGTCG	TGTATACTCTCACATATTCCCTTCAGTG
Pf3D7_07_v3-1358667-1358952-2	1358667	1358952	1358695	1358926	285	232	AAGGATCATTTCATTGAAGCCTCTAAAA	ACATAGCTTCCCAAAGTTTCTCTCTA
Pf3D7_07_v3-1359171-1359364-2	1359171	1359364	1359199	1359337	193	139	AGTAAATTTGAATGGCATACGTTATCGA	ACGCTTTTAACGAGAGTAGTAGTATGT
Pf3D7_07_v3-1359716-1359955-2	1359716	1359955	1359744	1359931	239	188	AGGAGGTACTGATTATTGGAATGATTTG	CCCCATTCACTAAACCATCTGAAG
Pf3D7_08_v3-102296-102531-2	102296	102531	102324	102503	235	180	AGAACTTGTCGCTATACCTTCATCTATT	TAGTTGTTGAAGAGTCAAGTTTTGTTCA
Pf3D7_08_v3-115232-115438-2	115232	115438	115256	115405	206	150	GACCCCGGAAAGGTTACAAATTAT	ATCTTTTGATGTGAATTTTTCATTACTATGATG
Pf3D7_08_v3-336439-336685-2	336439	336685	336469	336660	246	192	AATACATGAATATGATTAACAACGAACCCA	TTTTTCCCATCACTAAAAGGAAGAC
Pf3D7_08_v3-339140-339389-2	339140	339389	339169	339357	249	189	TGAGATAATCCTCCTGGAATATTTGTCAT	CTGAAGCGGTTGGATATTTGAAATATATATGT
Pf3D7_08_v3-398539-398776-2	398539	398776	398572	398744	237	173	TTCATTTTGTAACATTTCTACAATGTCAGTTAT	TTTTTGTACACCTACATATTGTAAAATCATGT
Pf3D7_08_v3-477346-477615-2	477346	477615	477374	477582	269	209	ACAGGTCTACCCATTGAACATTTTATAG	CTTGTTCATGTTATATGTACTTTGTATAGACTC
Pf3D7_08_v3-549963-550251-2	549963	550251	549993	550218	288	226	CATAAAAGAGGAAATCCACATACAATGGAT	GTGTATTTATTACAACATTTTGATCATTCATGC
Pf3D7_08_v3-562363-562651-2	562363	562651	562396	562618	288	223	CAATTTCATATAGCTAAAGAAATAGAAGGCTAT	ATTCAAAATTGCTTTTATCATTCATATGTTGTT
Pf3D7_08_v3-932991-933181-2	932991	933181	933019	933151	190	133	AACCTTGTAAAAGGAAAATGTCTTACGT	ATGCATATATTCAAAACCAATAGTACCACA
Pf3D7_08_v3-1056646-1056895-2	1056646	1056895	1056679	1056867	249	189	AGAAACAATTCTATGGATAATTCTGACAATATG	CATTGTCTAAAGCTTCGTTCTGAACTAT
Pf3D7_08_v3-1269295-1269482-2	1269295	1269482	1269321	1269455	187	135	CTCTTATATCAGGAGCAGCTATAGGA	TACTCCTCTTTGAAAAGCCAACTTTAC
Pf3D7_08_v3-1311910-1312173-2	1311910	1312173	1311942	1312142	263	201	GTACTTATAATTTGATGAACGATGGCTTTATG	CTTGATTAATTGTTGAACTAGTAGGAACAGT
Pf3D7_08_v3-1325094-1325343-2	1325094	1325343	1325127	1325311	249	185	ATTTTGCTACTTCAAAATCTAAGGTATAACATT	AACATAAAAACGTCCTTTATATCATCTAACTT
Pf3D7_08_v3-1344653-1344847-2	1344653	1344847	1344685	1344819	194	135	ATCTTTTCCATATATAATAACGCATGAATTCT	TGAGAACAGATGAAGTAACTACTCGATT
Pf3D7_08_v3-1362863-1363120-2	1362863	1363120	1362891	1363087	257	197	TCGACTTCTTTAAGAGAACAAACAGAAC	AAGTTTTCTTCTGAATAGTTCTACAAAGTATTT
Pf3D7_08_v3-1366744-1366993-2	1366744	1366993	1366772	1366965	249	194	CTCCTGAGGTAGCTTTAACTTCAAAAAT	GCTGTTATTACTGTTCCAGCTTATTTCA
Pf3D7_08_v3-1374975-1375255-2	1374975	1375255	1375003	1375229	280	227	GTGCTTGACTTTCGTGTAATAATCTCTT	GCTTCCGTACTTTTGTTAGATAACGT
Pf3D7_08_v3-1381244-1381492-2	1381244	1381492	1381277	1381463	248	187	AAAACCAAAAGCAATATAAATAAGATGAAATGT	AACACCAATTGTGTGAGTCCATATATTTT
Pf3D7_09_v3-158647-158911-2	158647	158911	158680	158883	264	204	ACATTTCTCTGATATCATTATTATAGCTATCGT	CCACTCTTTATGTTTGTTGAGGATAGTT
Pf3D7_09_v3-163035-163254-2	163035	163254	163068	163221	219	154	TCATCCAAACGATATAAATAAAACAGGTAATCT	ACCTTTATTTAATTCATTAGTTTTACCAAATGC
Pf3D7_09_v3-163577-163823-2	163577	163823	163602	163797	246	196	CAGCCAAACAAATTTTTGCTAACTC	TCATTTTGGGTAGTAGCTTGTAAAGC
Pf3D7_09_v3-516876-517125-2	516876	517125	516904	517092	249	189	CCATGCCCTGTGAATAGTATTACCTTAA	ATTTTGTATATCCAAAATTACATTGACAATTGT
Pf3D7_09_v3-596102-596365-2	596102	596365	596134	596334	263	201	ATTTGTTTTTGTTCTACATCAATAATTGGTTT	AAATAGAAGTCATATAGGTGACTGGAATCTT
Pf3D7_09_v3-687863-688088-2	687863	688088	687891	688056	225	166	AGAGGAATATATACATCCAAAGGTTCCC	TTTTTCATCTTTTTCTTTTATTAGATGCTCCT
Pf3D7_09_v3-1015102-1015372-2	1015102	1015372	1015130	1015342	270	213	AGCTACCGATTGAATAGTTGAATCTTTG	GTCGTTGTTTTCTATTTACTTTTGTTCCAA
Pf3D7_09_v3-1178862-1179111-2	1178862	1179111	1178894	1179078	249	185	TGAACGTTGAGAAATTACCTTTAGAAGATTAC	GCTCTTTTGTCTTGTAAAAATTCATTATATTCT
Pf3D7_09_v3-1202212-1202488-2	1202212	1202488	1202240	1202458	276	219	ATTCAGATGCTAAATCTTACGCTGATTT	GCACGAATTTTAAGATTGAAAGGTATTTGA
Pf3D7_09_v3-1360746-1360985-2	1360746	1360985	1360777	1360960	239	184	GACAAAACATGAACAAATTTCATACTTACCA	CCCACACTATCGAAGAACTGTTTTC
Pf3D7_09_v3-1406375-1406572-2	1406375	1406572	1406404	1406541	197	138	TCAGATTATCATAGTGTTGTGGATGAAGA	ATCACCTCGTATATATACAACATCATCTCTT
Pf3D7_09_v3-1437082-1437331-2	1437082	1437331	1437115	1437302	249	188	CATCATAATCATCTAATGATGTTAATCCTTGTA	GCACCATCATTAAATTTAGAAGAAACCCA
Pf3D7_10_v3-377028-377277-2	377028	377277	377061	377250	249	190	TTCGCAATATTTTATTCATACAACCATTTGAAA	TGCCCCTCTAGTTCATCTACTTTAAAT
Pf3D7_10_v3-404405-404653-2	404405	404653	404433	404621	248	189	CCAAATCTTAATCAACCTCATCCAGTTT	ATTCAATTATTTCATTTTTCGAACAATTGGAT
Pf3D7_10_v3-828360-828557-2	828360	828557	828387	828524	197	138	TTTATCAAACTTTGCTGTACCTTTGGA	TTGTTTTCACAAAATTTATTTTGATCATCATCA
Pf3D7_10_v3-992335-992572-2	992335	992572	992368	992544	237	177	AAATTGCCTATCATTAATGGAAAATATCCTCAT	TCCCTTTCAACTTTTTCATTTCAAGACT
Pf3D7_10_v3-1208133-1208382-2	1208133	1208382	1208158	1208354	249	197	GTTTATAATATGGCAGTGCCTCCTT	CACACCTCAGAAAAAGACTTATTCTTCA
Pf3D7_10_v3-1326317-1326605-2	1326317	1326605	1326350	1326574	288	225	GAATTCTCATCATCCTTATTTATGATATCACAT	GAGATGTTGATGATATGTATGAGTATGCTTT
Pf3D7_10_v3-1386666-1386909-2	1386666	1386909	1386694	1386876	243	183	CCATAAGTGCTACAGTTATATAGGACGA	AAACTTAAAAATGAGGACAAGGAAAATAATACA
Pf3D7_10_v3-1386986-1387218-2	1386986	1387218	1387018	1387187	232	170	TATGGTTTTACTACAATTTTTCGATAGCATCC	ATGCTCTATGAAAGTAAAATTATTCCAATCA
Pf3D7_10_v3-1399208-1399456-2	1399208	1399456	1399241	1399431	248	191	TCCATATTACCATTTGTTTAGTTACACTTAATT	TAGGAACATTTTCTGAAACAAGCGA
Pf3D7_10_v3-1399507-1399751-2	1399507	1399751	1399534	1399719	244	186	GATCAAGAAGGTCAAACTCATTCTGAA	AAGTCTTTATGTTTTTGATTAGGAAAAGGTTC
Pf3D7_10_v3-1399834-1400083-2	1399834	1400083	1399859	1400057	249	199	GAAGAAGATTCAGAACCATTTCCCA	CCTGGATATTTGTTTCTTGTTCAGGT
Pf3D7_10_v3-1436453-1436713-2	1436453	1436713	1436481	1436680	260	200	TAGGAATCGAATAAATGAGGAAAAGCAC	TCGTCATCATCATTTATTATGTGTTCAATTAAT
Pf3D7_10_v3-1569831-1570100-2	1569831	1570100	1569864	1570076	269	213	AGAGAAATAGAAAATGAAGAAAATCGTGAATAT	CCCATTCGCTTCTTCAATTTCTGT
Pf3D7_11_v3-119457-119726-2	119457	119726	119486	119693	269	208	GCTTCCATCTCCTTTATATTCATCAAGAA	GGAATTTTTAATGAATGGATTAAAACTAGTGAA
Pf3D7_11_v3-356205-356478-2	356205	356478	356233	356450	273	218	AGGGAAAAATTCGAACAATGAAGAAGAT	GTCATTTTCTTCCACTAATCCGGAATAA
Pf3D7_11_v3-690150-690344-2	690150	690344	690175	690315	194	141	CGATGTTCTTCTTCGGTAACATTGT	CCGAACTAGTGATAATATAAAACCCGAAA
Pf3D7_11_v3-884594-884796-2	884594	884796	884622	884768	202	147	AATTTACGAACAGAATGAAAACCAAACG	ATAAGTCTTTAAAATGTGTAAGGCACGT
Pf3D7_11_v3-1009823-1010072-2	1009823	1010072	1009855	1010039	249	185	GAAAATATTAAACTGTGAGCATATCTTGGTTC	TTGTTGATGAAACATATAAATTTGATTTCCAAG
Pf3D7_11_v3-1018902-1019114-2	1018902	1019114	1018935	1019086	212	152	GGCTAATAATAATTCTGTAGCTATACTACTACT	CCTCCTTTAGGTATTACGGTAGCAATAA
Pf3D7_11_v3-1019442-1019630-2	1019442	1019630	1019468	1019602	188	135	CTTCTCCGCTATCATTAAACATGGAA	TGCCCAGATTTAAATATAACAGCAAAGG
Pf3D7_11_v3-1293920-1294097-2	1293920	1294097	1293947	1294072	177	126	GAAGAGGACAGAATTATTGGGAACATC	TGGTCTATTGGATATGCGTGTTGTA
Pf3D7_11_v3-1294295-1294580-2	1294295	1294580	1294325	1294547	285	223	GGAAATGTCCAGTATTTGGTAAAGGTATAA	TCATCATAAACAGCTGGATATTTATAATTTGAA
Pf3D7_11_v3-1376159-1376403-2	1376159	1376403	1376184	1376374	244	191	GCTGCAAATTGAGCCATAGAAAAAT	GCGATAACACTAGATGTAAGATATGCATC
Pf3D7_11_v3-1419781-1419997-2	1419781	1419997	1419805	1419967	216	163	GTCGTCGTCATTATCTCCTTCATC	ATGCACATCTATACATGTGAATGATTTAGG
Pf3D7_11_v3-1529617-1529864-2	1529617	1529864	1529649	1529837	247	189	AGGATAAGAATTAACATTTCGACTGCTAAAAT	GTACAAATGCAAATCGTTATCAACAGG
Pf3D7_11_v3-1552398-1552685-2	1552398	1552685	1552431	1552655	287	225	AAGGGAAAAATAATGGATAATATAGTTGTGAAT	ATTTAGTTCTATACCTTTGTCAATTTGCTC
Pf3D7_11_v3-1750834-1751083-2	1750834	1751083	1750866	1751054	249	189	CATCAACATATAGTCGTTATAAAAGAGCACTT	GGCGTTTCCTCATTTTCTTTACTATTGTA
Pf3D7_11_v3-1816182-1816451-2	1816182	1816451	1816212	1816423	269	212	GGGTAGATATCGTTATAAGGGCTATAATGT	CCAAAAATACGATGTGATGAAGAATGAA
Pf3D7_12_v3-63130-63317-2	63130	63317	63162	63285	187	124	TTGCATACATTCTATTAAAAACTTTGGGTACT	AACAACACATTTATCTTATTTACCCGTATCTC
Pf3D7_12_v3-77012-77235-2	77012	77235	77044	77202	223	159	CCCTGCAATTTTTCTAATTCACTTTTGATAAG	AAAGATATTAAAGAACTAGAAGAAGTCATCTCG
Pf3D7_12_v3-371946-372165-2	371946	372165	371973	372133	219	161	ACGTTCCTCTCAAATATTTTCTGATGC	ACCATAACAAAAACAATATACAAGTAATGGTT
Pf3D7_12_v3-418763-419042-2	418763	419042	418793	419010	279	218	ATGTACACCAACCAAAACATATATTAAAGA	TTCTTGATGATCATCATTTTCTTCATCATCAA
Pf3D7_12_v3-659859-660039-2	659859	660039	659892	660012	180	121	GTTAATACTGGTACTATTATACCATATGTTGCT	ATTCACCAACCTTTTTAGAATCAAGCT
Pf3D7_12_v3-684052-684301-2	684052	684301	684082	684276	249	195	GTTGGTAAGTCTACCATTTTTAATCGACTA	CACCATGTATACCATCAACGACAAA
Pf3D7_12_v3-802593-802784-2	802593	802784	802622	802751	191	130	GTGAAGATGAATCAAAGGAAATTTCTTCC	TTTGAAATTTCTCTTTGTAACATTTTATTTCCA
Pf3D7_12_v3-907063-907352-2	907063	907352	907095	907321	289	227	AGATGTACAAAATTTGAAGTACCAACATATAC	ATTTTCCTTAGAACAATTAGTTTCTATGCTT
Pf3D7_12_v3-943228-943456-2	943228	943456	943259	943428	228	170	ACCCTACTTATACAAAGAGATAAAGAAGTAG	AATTCCCTTTTTGTTTGGTTTCCATATT
Pf3D7_12_v3-1022568-1022802-2	1022568	1022802	1022592	1022778	234	187	GGATGATATTCCCACGACGTCTAA	AAAATTGTAGCAGCACACCCATAA
Pf3D7_12_v3-1398778-1398953-2	1398778	1398953	1398810	1398926	175	117	AATGTATATAATAATGATTCTAGCCCAAAGGA	TCTGTGGATAATTCTTGGTCCTTATGA
Pf3D7_12_v3-1597948-1598162-2	1597948	1598162	1597980	1598134	214	155	ATTAGACATTTATGAAAAGGAACAAAAGGATA	CCACTTCAATATTTTCTCCCTCCAATTT
Pf3D7_12_v3-1850283-1850563-2	1850283	1850563	1850312	1850534	280	223	AAATGAAACACAATGTTTTTGGTTAGAAT	TTTTTAAATTGAACGGTGTTTCATTAAGC
Pf3D7_12_v3-2050100-2050346-2	2050100	2050346	2050126	2050314	246	189	CCACTTGGTTTTGATTATCTCCCATT	AAAAACATACCTAGACATTTGAATGTCTTAGA
Pf3D7_13_v3-103212-103497-2	103212	103497	103245	103470	285	226	TGTGTGATCAAAAAGAAGAAATATATAAAGAGT	GGAGGCTGACTTTTAATTCTTGGTTTT
Pf3D7_13_v3-103632-103916-2	103632	103916	103660	103887	284	228	GAAAAGAAGATCCAACTGACAGAGAAAA	ATGTAGTTGATTGTGTACTAGATAATGCA
Pf3D7_13_v3-156543-156740-2	156543	156740	156576	156708	197	133	AGTATATACAATAGTACACCTCCATATAGAGTT	AGAATTGCTCATTAATCTATTTTGTTGATTTG
Pf3D7_13_v3-301871-302143-2	301871	302143	301904	302115	272	212	ACCATATAAATATTGTTGAAGTAGAGGATAAGA	CAAAGAGAAATGTGTCTGATGATGTGTA
Pf3D7_13_v3-530399-530648-2	530399	530648	530427	530622	249	196	GAAACAGGTGTTTTATTATCCAGAGGTT	CTGATGAAGAACCATCACCACAATAA
Pf3D7_13_v3-757337-757521-2	757337	757521	757365	757492	184	128	TAGGGTTCTTCTTACCGTTTTATCGTAA	GGCTTTTTCATTGGACATATATTTGTGAG
Pf3D7_13_v3-937346-937594-2	937346	937594	937376	937563	248	188	ACATTCAATCCTTTTACCCAAACTTTTACA	GGACATTTTTCAATAAATTCATCAACTTTGC
Pf3D7_13_v3-1150280-1150528-2	1150280	1150528	1150304	1150495	248	192	TAACAACCCCTCCATCAACATCTT	CAACACTTCTATATCTTCTTTCTTCATCATTCT
Pf3D7_13_v3-1419520-1419711-2	1419520	1419711	1419544	1419681	191	138	GAAATGTCGATTCTCCTCCTTGTG	AACAAGAAGATGAAAACAAGGAAAAATCAG
Pf3D7_13_v3-1465124-1465399-2	1465124	1465399	1465149	1465373	275	225	TTATCTGGCTTTTCATGTTCTTCCC	GAAACCCGAAAATAAGCACGATAATC
Pf3D7_13_v3-1465557-1465838-2	1465557	1465838	1465584	1465810	281	227	GATTTGGTGGATTTTCTGGATTTTCAT	CCAGGTCAAGAAAAAGAGAAATCTTACA
Pf3D7_13_v3-1466169-1466418-2	1466169	1466418	1466202	1466390	249	189	CTCTATTGATTCGGTCATTTAAATGTTTTCTTA	GCAGTACCTCTAGCTATGAAATTGATAC
Pf3D7_13_v3-1725322-1725608-2	1725322	1725608	1725355	1725582	286	228	TCATATGCTTCTACATTCGGTATAATAGAAGAG	GATATTAGTCAACAATGCTGGCGTAT
Pf3D7_13_v3-1865917-1866120-2	1865917	1866120	1865943	1866090	203	148	ACCTATCAATGTGATAACAGCAGAGA	GACATAGGATCTATTAAATCATTGCTTCCC
Pf3D7_13_v3-1876326-1876575-2	1876326	1876575	1876353	1876543	249	191	CCAGGACAATTTAAACCTACCAAATGA	ATGTTACATCAAAAGATGTTAATACAGAATGT
Pf3D7_13_v3-1879437-1879717-2	1879437	1879717	1879469	1879684	280	216	ATGGAAGGCATTTTTATAACCACATTATTATT	AATATCCCAGGACAAGATAAAATATTAAAAGGA
Pf3D7_13_v3-2114934-2115174-2	2114934	2115174	2114966	2115142	240	177	ATGAACTTCTGTATCTATAGTCGATTTTGTTA	ACATTTTATTGTTGTTAGAATACCTCTAGTTT
Pf3D7_13_v3-2115442-2115731-2	2115442	2115731	2115470	2115701	289	232	AATGGACGTAATACTGCATTCATATTTT	GATGACAAGATTAAAAATACATCAGGCTCT
Pf3D7_13_v3-2124600-2124876-2	2124600	2124876	2124633	2124847	276	215	ACTAATTTGGTTTCAATAAAATTATCAGCTTTC	GAAGAATTTTAACACAAGGAGATCATCAC
Pf3D7_13_v3-2180819-2181106-2	2180819	2181106	2180852	2181073	287	222	TCACGTATCTATGAAAAAGGATATGTGTATATA	TTAACATGAATAGACTATTCGATTTTGAACATA
Pf3D7_13_v3-2298780-2299062-2	2298780	2299062	2298811	2299035	282	225	AGCTTGGTGAAATAATTAATAAAACCACTAG	GCCAAACAGAAAATCGAAAAGATTCAT
Pf3D7_13_v3-2479053-2479277-2	2479053	2479277	2479084	2479248	224	165	GAGCTTATAAAGAGAAATTTTCATGTTAGCG	AAAGTCTTCCTTGATTTCTTTATCCAAGG
Pf3D7_13_v3-2481043-2481330-2	2481043	2481330	2481076	2481301	287	226	GTTTCAAGTCTGCTTTATCAAAAATGAATAATA	GGCTTGCTTTCCATTTAAATAATAACCTT
Pf3D7_13_v3-2545648-2545834-2	2545648	2545834	2545677	2545807	186	131	AACATCACCTTTATTAAACTGACCATTAA	TAGTGGAGATTGGAATGGACAAGTTAT
Pf3D7_13_v3-2669103-2669348-2	2669103	2669348	2669134	2669316	245	183	AAATTTACATGATGTAACTGAATCTCAGCTT	TGGTATAGTAGCCAGTATTCTTTTTATGAAGT
Pf3D7_13_v3-2735433-2735625-2	2735433	2735625	2735466	2735596	192	131	AAAAATATTGTATTCTTTAGGAGTGACGTTTAA	ATTATTAGACCATCCTGAGGAAAAAGAAA
Pf3D7_13_v3-2837411-2837659-2	2837411	2837659	2837436	2837626	248	191	TGCTGACGATATGAATGATGACATG	TTCATATTATTCTCTTCATTCAAATTATCAGCT
Pf3D7_14_v3-39921-40170-2	39921	40170	39954	40137	249	184	CCAACTATATCTGTTCCATAAATGGTTATATTT	ATTTATTTGGATTGAGATCTTAATGTTCAAAGT
Pf3D7_14_v3-120179-120383-2	120179	120383	120203	120353	204	151	CACATATCGCGTCCTTATCACATC	AAACAGAAAGAATGGTTTAGAAATGTACGA
Pf3D7_14_v3-150076-150318-2	150076	150318	150106	150294	242	189	CCGAAAATAGAACTCCATATGTTCATTACC	GTCTGGAACGAGAAGATGTCTTTG
Pf3D7_14_v3-279619-279824-2	279619	279824	279649	279797	205	149	ATTTCTTAGGTTTATTCCGGATAAATGTTT	ATTTCCCATTACTTATGGGAAGTTTCG
Pf3D7_14_v3-407347-407604-2	407347	407604	407380	407571	257	192	TCGTCTTTCTGTTCATTATCCATATAATCTTTT	TGAACTCTTTAAATTATCCTTTTTGAATATCCA
Pf3D7_14_v3-564178-564409-2	564178	564409	564209	564377	231	169	AAAATCTTTTGGTATTGTATTTTGACTGCAC	AAACGGAATCACTTATGGATACCATTTTATTT
Pf3D7_14_v3-774286-774567-2	774286	774567	774316	774542	281	227	TTTGTTATCAATTTGGTGAACAAACACAAT	AGCTTGTCCATAAAACGATAAACGT
Pf3D7_14_v3-1038341-1038518-2	1038341	1038518	1038370	1038486	177	117	ACACTTCAACTACACTTTTTAATTTAGCC	AGATCTTATGTTAAACTTCTAGAAGATGAAGT
Pf3D7_14_v3-1224342-1224519-2	1224342	1224519	1224374	1224486	177	113	AGCAGGTACTGAAAAATTCAAAATCATAATTA	TCAGATGATATATGGAAAATAAACAAATGTTCT
Pf3D7_14_v3-1719580-1719758-2	1719580	1719758	1719612	1719725	178	114	AATTCTCAAAATAAAATCTGCAGAAATTCTTT	TTCTTATTCTGTTTATTTGGTGAACATTTAGAG
Pf3D7_14_v3-1956097-1956331-2	1956097	1956331	1956130	1956303	234	174	TTTTTCTCCACTTTGTAATTTTTATTGTTGAAT	TGGTATTCTAGTAAAAATTCGGGTGGTA
Pf3D7_14_v3-1971404-1971692-2	1971404	1971692	1971437	1971660	288	224	CCAAATTTCATCATATTCATTACGGTTACAAGA	ATTGATTATTTTTCTTTTGCCTTATAGTTCCA
Pf3D7_14_v3-1992214-1992458-2	1992214	1992458	1992241	1992426	244	186	TCTTTTTATCACATTCAAAGACGGCAT	ATCTTATTATGAAAGCTGTACATCCGATTTTA
Pf3D7_14_v3-2081372-2081631-2	2081372	2081631	2081401	2081598	259	198	TTCGGTCTTCTTCATTTGATTTCTTAACA	CTCCCAATTTTTATAAAGCATTAATTACAGAAA
Pf3D7_14_v3-2086329-2086533-2	2086329	2086533	2086362	2086503	204	142	TCCTTCTATAACCTTTGTATTATTTTCATGTGT	ACAAGAACTTTCTAATGCTCAAACAATAGT
Pf3D7_14_v3-2355672-2355854-2	2355672	2355854	2355704	2355821	182	118	ACCCATTTAACGAGTATGAAAAATATGACAAA	ATGACATAATAATATCGTTTTTGGATTGTATCC
Pf3D7_14_v3-2524932-2525119-2	2524932	2525119	2524963	2525089	187	127	ATGATCTTCTCTGAAATTTACTTGAATTGTT	ACCAAACTTTTGGAGATTTCAAGATTATGA
Pf3D7_14_v3-2575499-2575689-2	2575499	2575689	2575532	2575663	190	132	TGATAACGATAATAAATTTGAAGAAGATGAAGA	CATTATTATTTAACGTCGCTGGGTCA
Pf3D7_14_v3-3091081-3091326-2	3091081	3091326	3091112	3091294	245	183	TTGTATTTGTAATTCTTTAGCTTCCTGAACA	ATTAATAAAAGTTCATCCTTTTTGAACCAAAA
Pf3D7_14_v3-3120886-3121174-2	3120886	3121174	3120906	3121141	288	236	GGGAAATGCACTACGCTCAA	TGTAACTCCACCTGAATTATATAATGTAGAAGA
Pf3D7_14_v3-3121631-3121844-2	3121631	3121844	3121664	3121811	213	148	AAACAAAATAAAGAAGAAAAACAAGAAGAAGAT	CATTTATGTATGTTACTTCTTCTTCATCTTCAT
Pf3D7_14_v3-3124615-3124870-2	3124615	3124870	3124643	3124840	255	198	CAGATTATTTGGTAATGAACAACCAGGA	AGGTCTTCCTAATCTTGAACCATCATATAA
Pf3D7_14_v3-3125993-3126258-2	3125993	3126258	3126026	3126229	265	204	TCAAATGAAGATTTTCCGTTAATAAAAGAAAAT	CCATCTCTAGGTAATAACGTACCATTAGA
Pf3D7_14_v3-3189468-3189697-2	3189468	3189697	3189501	3189672	229	172	TGGTAAAAATGAAGCATTTAAAAAGTATTCACA	TAAGCCTCTCGTTATTTTGCACAAG
Pf3D7_14_v3-3193634-3193838-2	3193634	3193838	3193667	3193812	204	146	GAAAAATGTTAGAAGATTATTGTTATGAAAGGG	CTCAACGTACAACCACTGTCTATATG
Pf3D7_14_v3-3214254-3214502-2	3214254	3214502	3214284	3214477	248	194	AATTCATTTATGGAATCATACACTTGGTGT	TCAATTGATGGTTGCCTTTCGATTA
