amplicon	amplicon_start	amplicon_end	ampInsert_start	ampInsert_end	amplicon_length	ampInsert_length	fwd_primer	rev_primer
Pf3D7_01_v3-145416-145655-1	145416	145655	145450	145622	239	173	TGTTCGATATGTTTAAATATATGATTCTCGAAA	CCAATATGTCAAGGTATATTAAAGTATGGTATC
Pf3D7_01_v3-179874-180148-1	179874	180148	179904	180115	274	212	AACAACAAGCTTTGTCGCTAAAATTAATT	TCTGATACCTATAGCTTCCATATTTTCATATTT
Pf3D7_01_v3-181524-181699-1	181524	181699	181558	181673	175	116	TCTATTAGCTTTTTCAAACCTTTCATTATTGTT	AGCTTAGGCAAAAATTGGTGAAAATG
Pf3D7_01_v3-495941-496171-1	495941	496171	495972	496143	230	172	GCCACCAAAATATTATATACCACAAGACAA	AAGGAAAATCTTTGGTGGGAAAAATAGA
Pf3D7_01_v3-512168-512418-1	512168	512418	512200	512388	250	189	CGAATCAAAGGTAGAAAATGATCTTGAAGAA	CTGTGGATTATTTATACGATTCCTTTGACA
Pf3D7_01_v3-531656-531930-1	531656	531930	531683	531900	274	218	CTTTTTGGGCTTATTGTTTGGAAGAA	ACTGGATTCTTCTAATATTCTTTGCTCTCT
Pf3D7_01_v3-532660-532872-1	532660	532872	532691	532844	212	154	GGGAAGAATGGTTTAATCGTAAAAATGAAG	GTCTTCGAAATAATGAACTCCCTTTTCT
Pf3D7_01_v3-534182-534397-1	534182	534397	534216	534368	215	153	TTCAGATGTGATAAATATATGTGACATTTGTAA	AAAAATATAAGAGATTCAAAGGGTCAGAC
Pf3D7_01_v3-534908-535143-1	534908	535143	534942	535110	235	169	TGTATGTGTGTTGATTGTAATTATAAGAATTGT	CTACAAAAATTATGAAAAAGTTTGGTTCCTTTT
Pf3D7_02_v3-109776-110014-1	109776	110014	109808	109982	238	175	CCACCATTTCTTCATTTTAATTTTGAATGGT	ACCATTTGGATTAAAACCTTCAGATTTAAATA
Pf3D7_02_v3-278144-278369-1	278144	278369	278166	278336	225	171	CTTACCATTCGCGCTTTCTTG	AATATAGTACCAGAAAATGGAAGAATGTTAAAT
Pf3D7_02_v3-470459-470709-1	470459	470709	470493	470676	250	184	TGAACATGAAGAATATTGACATGAAACATTATA	GTATGTATTATACCCTCCATTTGATTATTCTCT
Pf3D7_02_v3-805795-805970-1	805795	805970	805823	805942	175	120	TTGGAAAATTTGAGAATCCTATGTGCT	TTCGATTTGCCTACAATTTGTGATTCTA
Pf3D7_03_v3-85407-85679-1	85407	85679	85441	85646	272	206	ACCCATAGAAATGTTAAATGATATTTTTCTTCT	GAAGAAGTATTAAATGAAGAATTTTCAGATGCT
Pf3D7_03_v3-141936-142210-1	141936	142210	141964	142181	274	218	AAAGCGAATAATGCCAATATGTTGTTC	TTTTTACAACTGACAAATTTGTTTTGTGT
Pf3D7_03_v3-221330-221521-1	221330	221521	221364	221495	191	132	GGAACAAGAAGGATAATACCATTATTAATCCTA	CCCATGTAGTGTAACTTGTGGAAATG
Pf3D7_03_v3-618367-618613-1	618367	618613	618397	618581	246	185	GGGACACTACAGACAAAAATAAATGATCT	AGAAACTCCTACTACCAATAATTTGACATTTT
Pf3D7_03_v3-653972-654204-1	653972	654204	654003	654175	232	173	TCACCTAACGGTATATTTTTATCTCGTACA	TTATGTATTTTTCAAAAATCGGCACGTTT
Pf3D7_03_v3-850788-851017-1	850788	851017	850817	850989	229	173	CCATTTTTATCTACACGTACTACATGCA	AAATGTCTCTAAGAGTTACAGGAACAGA
Pf3D7_04_v3-109879-110114-1	109879	110114	109913	110087	235	175	TTTTAAAACTGGCAAATTATTTATTTCTGTCAT	CATGAAACCGAAAACCCATTTTTCTTA
Pf3D7_04_v3-133463-133726-1	133463	133726	133492	133701	263	210	TTTTGGTTCAGTACTATCTCTTGCATTT	CGACACCAAATATTCAAGAAGAACC
Pf3D7_04_v3-141751-141975-1	141751	141975	141779	141945	224	167	GATACACGTGATGAATACCATATAGCC	AGATCAAGCATTTGTCTGTCTATATCTCTT
Pf3D7_04_v3-415623-415859-1	415623	415859	415654	415826	236	173	ATGAATTAATAAAAGAACATGGTGGACCTT	GACTTGAAAACATTTTAAATTTCTTGTATCCAT
Pf3D7_04_v3-544686-544888-1	544686	544888	544719	544861	202	143	AACCCAGATAATCATTTATTAAATACAGACAC	CTGCAGCACACATTATAACTAAATGTG
Pf3D7_04_v3-748200-748469-1	748200	748469	748231	748436	269	206	AGGTCTAGGAAATAAAGGAGTATTACCATG	ACAATATAACATTTATCCTATTGCTTAAAGGTT
Pf3D7_04_v3-748500-748725-1	748500	748725	748534	748696	225	163	AGATGTTTATATCATTAACAAAGTTGAAGATCT	ACATCGCTAACAGAAATAATTTGATACTC
Pf3D7_04_v3-802494-802740-1	802494	802740	802526	802713	246	188	AAGCATCTGAACATTAAAGTTCAAACAAATA	GCACATCGAATAATCTTCTTTGTGATT
Pf3D7_04_v3-1037602-1037868-1	1037602	1037868	1037635	1037844	266	210	ATTGAAGTACAATATGAAATCGATCTTGATAA	GTATTTGGTTTGTCAGGCAATTCG
Pf3D7_04_v3-1100629-1100863-1	1100629	1100863	1100657	1100831	234	175	CCCAAAACGGTTAATACTGAAGTTAGA	AGAAGAAGGACTTTTATAATTATCATCACCAT
Pf3D7_04_v3-1102362-1102606-1	1102362	1102606	1102390	1102578	244	189	CGTAGAGGTGTTGATGTTAATATGGAG	CATCCAAACATACATCCTCTTTTTGTTC
Pf3D7_04_v3-1113422-1113632-1	1113422	1113632	1113451	1113604	210	154	GATTCTGCATGCAGTAATGAATCTATTG	CGTAGCATGCTCAGATATTATGATGATT
Pf3D7_04_v3-1128461-1128705-1	1128461	1128705	1128490	1128673	244	184	CTGTCGCAAAAGAAGGTTTTGATAATAT	ATGAATGAATAAATCAATTTTACCACGTCATT
Pf3D7_05_v3-329351-329578-1	329351	329578	329379	329550	227	172	GTGTTAAAACAACAGGAGGAACACTAA	TGTTGTAGAATATTCGTGTCCGTATAGT
Pf3D7_05_v3-958027-958254-1	958027	958254	958060	958221	227	162	AAATGTTTACCTGCACAACATAGAAAATTATT	TTTGATGTAATTACATCCATACAATAACTTGAT
Pf3D7_05_v3-958362-958539-1	958362	958539	958390	958506	177	117	TTTAGAACAAGTGAGTTCAGGAATTGG	TTTACTTTCTTATTACATATGACACCACAAACA
Pf3D7_05_v3-1042129-1042311-1	1042129	1042311	1042163	1042281	182	119	GGAATATTTGTGATTTAGGATGTAATGCATACA	CAAATATATCTCTTCGCATGTTTCTAAGGA
Pf3D7_05_v3-1309581-1309771-1	1309581	1309771	1309610	1309744	190	135	ACGACGAAGAAAACGAAAGTATTGATAA	ACCTCTTGAAATTCCTTTTCAACTTGA
Pf3D7_06_v3-145315-145530-1	145315	145530	145344	145501	215	158	CAATCAACAAAAGCTGATGAATCATCAT	AAGGAAGGTAGAATATCAAATACAAGGGA
Pf3D7_06_v3-532167-532405-1	532167	532405	532196	532378	238	183	ATCAAGCTGAATCTATCCTATTGGATCA	GTATATTGTTTATTGGGATCCCCTTCC
Pf3D7_07_v3-165202-165450-1	165202	165450	165236	165422	248	187	GGATCCTCTTACAATCTCGAAATAATTATAATT	ATGGTTTGGTAAGCGAGTTTATGTTATT
Pf3D7_07_v3-166002-166197-1	166002	166197	166036	166167	195	132	AGGATATGTTCTTTTTAAAGTTCTCTTCATTTT	CGTTAAATGTAGAAAAGACGAAATCATCCA
Pf3D7_07_v3-298857-299033-1	298857	299033	298887	299005	176	119	TAGATATATCATTCACAGTCGTCTCATGG	TGTTAAGTTTTCTCTTGTGGAATCGAAT
Pf3D7_07_v3-729943-730118-1	729943	730118	729976	730088	175	113	AATAAGAAATATGTCTTACAAGGAGATGTTTT	AAACATTATGTAGTCAACATATGAAGGAAA
Pf3D7_07_v3-1149387-1149613-1	1149387	1149613	1149416	1149585	226	170	TGGACATGTAGATATTTGACTAGTCGAA	TGTATACTCTCACATATTCCCTTCAGTG
Pf3D7_07_v3-1358666-1358941-1	1358666	1358941	1358695	1358911	275	217	AAGGATCATTTCATTGAAGCCTCTAAAA	CAAAGTTTCTCTCTAAATTCATTCCACCAT
Pf3D7_08_v3-102298-102527-1	102298	102527	102327	102500	229	174	ACTTGTCGCTATACCTTCATCTATTGAA	TGTTGAAGAGTCAAGTTTTGTTCAGAA
Pf3D7_08_v3-336438-336674-1	336438	336674	336469	336647	236	179	AATACATGAATATGATTAACAACGAACCCA	ACTAAAAGGAAGACAAGCTGAAAACAT
Pf3D7_08_v3-339139-339389-1	339139	339389	339169	339357	250	189	TGAGATAATCCTCCTGGAATATTTGTCAT	CTGAAGCGGTTGGATATTTGAAATATATATGT
Pf3D7_08_v3-549962-550251-1	549962	550251	549994	550218	289	225	CATAAAAGAGGAAATCCACATACAATGGATA	GTGTATTTATTACAACATTTTGATCATTCATGC
Pf3D7_08_v3-932995-933173-1	932995	933173	933024	933143	178	120	TGTAAAAGGAAAATGTCTTACGTGGATT	ATTCAAAACCAATAGTACCACAATATGTTT
Pf3D7_08_v3-1269294-1269485-1	1269294	1269485	1269321	1269456	191	136	CTCTTATATCAGGAGCAGCTATAGGA	TTTTACTCCTCTTTGAAAAGCCAACTTTA
Pf3D7_08_v3-1344653-1344847-1	1344653	1344847	1344687	1344819	194	133	TCTTTTCCATATATAATAACGCATGAATTCTTT	TGAGAACAGATGAAGTAACTACTCGATT
Pf3D7_08_v3-1362863-1363120-1	1362863	1363120	1362892	1363087	257	196	CGACTTCTTTAAGAGAACAAACAGAACA	AAGTTTTCTTCTGAATAGTTCTACAAAGTATTT
Pf3D7_09_v3-516904-517125-1	516904	517125	516929	517092	221	164	TGTGGGCGCAAAAACTATAAATGA	ATTTTGTATATCCAAAATTACATTGACAATTGT
Pf3D7_09_v3-596101-596365-1	596101	596365	596134	596334	264	201	ATTTGTTTTTGTTCTACATCAATAATTGGTTT	AAATAGAAGTCATATAGGTGACTGGAATCTT
Pf3D7_09_v3-685583-685825-1	685583	685825	685602	685792	242	191	CACGCGAACCAAACAACG	GGGCGAAATTCTATGAATGTATTATTAATAGAA
Pf3D7_09_v3-1178862-1179111-1	1178862	1179111	1178895	1179078	249	184	GAACGTTGAGAAATTACCTTTAGAAGATTACT	GCTCTTTTGTCTTGTAAAAATTCATTATATTCT
Pf3D7_09_v3-1406375-1406572-1	1406375	1406572	1406406	1406541	197	136	CAGATTATCATAGTGTTGTGGATGAAGATT	ATCACCTCGTATATATACAACATCATCTCTT
Pf3D7_09_v3-1437081-1437331-1	1437081	1437331	1437115	1437303	250	189	CATCATAATCATCTAATGATGTTAATCCTTGTA	GCACCATCATTAAATTTAGAAGAAACCC
Pf3D7_10_v3-377062-377237-1	377062	377237	377096	377209	175	114	AAACAAATAGCATTCGATAAATTTGAAAATTTC	CTTCATCTATATAGTCCCCGATGAATGA
Pf3D7_10_v3-992338-992572-1	992338	992572	992372	992544	234	173	TGCCTATCATTAATGGAAAATATCCTCATTATA	TCCCTTTCAACTTTTTCATTTCAAGACT
Pf3D7_10_v3-1386672-1386902-1	1386672	1386902	1386701	1386869	230	169	TGCTACAGTTATATAGGACGATTTTGGT	AAAATGAGGACAAGGAAAATAATACATTCATAA
Pf3D7_10_v3-1399515-1399741-1	1399515	1399741	1399545	1399711	226	167	GGTCAAACTCATTCTGAATTAAATCCTGA	GTTTTTGATTAGGAAAAGGTTCTGTTGAAA
Pf3D7_10_v3-1436451-1436714-1	1436451	1436714	1436480	1436682	263	203	CTAGGAATCGAATAAATGAGGAAAAGCA	ATCGTCATCATCATTTATTATGTGTTCAATTA
Pf3D7_11_v3-119456-119726-1	119456	119726	119487	119693	270	207	GCTTCCATCTCCTTTATATTCATCAAGAAA	GGAATTTTTAATGAATGGATTAAAACTAGTGAA
Pf3D7_11_v3-1009831-1010071-1	1009831	1010071	1009857	1010038	240	182	AAACTGTGAGCATATCTTGGTTCAG	TGTTGATGAAACATATAAATTTGATTTCCAAGC
Pf3D7_11_v3-1018920-1019113-1	1018920	1019113	1018954	1019085	193	132	GCTATACTACTACTTATGTTACTTATACCACAT	CTCCTTTAGGTATTACGGTAGCAATAAG
Pf3D7_11_v3-1376159-1376402-1	1376159	1376402	1376186	1376372	243	187	CTGCAAATTGAGCCATAGAAAAATGA	CGATAACACTAGATGTAAGATATGCATCAT
Pf3D7_11_v3-1552397-1552667-1	1552397	1552667	1552431	1552640	270	210	AAGGGAAAAATAATGGATAATATAGTTGTGAAT	GTCAATTTGCTCCTTATCCATATTCGA
Pf3D7_11_v3-1750833-1751083-1	1750833	1751083	1750866	1751055	250	190	CATCAACATATAGTCGTTATAAAAGAGCACTT	GGCGTTTCCTCATTTTCTTTACTATTGT
Pf3D7_11_v3-1816181-1816452-1	1816181	1816452	1816212	1816425	271	214	GGGTAGATATCGTTATAAGGGCTATAATGT	GCCAAAAATACGATGTGATGAAGAATG
Pf3D7_12_v3-63135-63313-1	63135	63313	63167	63280	178	114	ACATTCTATTAAAAACTTTGGGTACTCCTAA	ACACATTTATCTTATTTACCCGTATCTCATATA
Pf3D7_12_v3-659858-660037-1	659858	660037	659892	660010	179	119	GTTAATACTGGTACTATTATACCATATGTTGCT	TCACCAACCTTTTTAGAATCAAGCTTT
Pf3D7_12_v3-684059-684289-1	684059	684289	684089	684261	230	173	GTCTACCATTTTTAATCGACTAACTCGAA	CATCAACGACAAAAATAACAACTGATGA
Pf3D7_12_v3-943227-943456-1	943227	943456	943259	943428	229	170	ACCCTACTTATACAAAGAGATAAAGAAGTAG	AATTCCCTTTTTGTTTGGTTTCCATATT
Pf3D7_12_v3-1237407-1237636-1	1237407	1237636	1237432	1237603	229	172	CGAATGCTTGTGTGATCAATGAAA	ACCTCTTTCAAAACATTCTCTTTTATTAATACA
Pf3D7_12_v3-2050103-2050346-1	2050103	2050346	2050131	2050314	243	184	TTGGTTTTGATTATCTCCCATTTTCGT	AAAAACATACCTAGACATTTGAATGTCTTAGA
Pf3D7_13_v3-103631-103905-1	103631	103905	103660	103879	274	220	GAAAAGAAGATCCAACTGACAGAGAAAA	TGTGTACTAGATAATGCAGGAACTGA
Pf3D7_13_v3-156535-156753-1	156535	156753	156567	156722	218	156	AACTGAAAGTATATACAATAGTACACCTCCA	AAAAGGATAAGTTAGAATTGCTCATTAATCT
Pf3D7_13_v3-1150279-1150526-1	1150279	1150526	1150304	1150493	247	190	TAACAACCCCTCCATCAACATCTT	ACACTTCTATATCTTCTTTCTTCATCATTCTTA
Pf3D7_13_v3-1419519-1419700-1	1419519	1419700	1419544	1419670	181	127	GAAATGTCGATTCTCCTCCTTGTG	GAAAACAAGGAAAAATCAGAATCATTTCCA
Pf3D7_13_v3-1725337-1725592-1	1725337	1725592	1725366	1725570	255	205	TCGGTATAATAGAAGAGCCATCATATCC	GCTGGCGTATGTGTACACCTAT
Pf3D7_13_v3-1876325-1876566-1	1876325	1876566	1876353	1876534	241	182	CCAGGACAATTTAAACCTACCAAATGA	CAAAAGATGTTAATACAGAATGTACATGCAAA
Pf3D7_13_v3-2114942-2115174-1	2114942	2115174	2114976	2115142	232	167	TGTATCTATAGTCGATTTTGTTATTCTAAGCAT	ACATTTTATTGTTGTTAGAATACCTCTAGTTT
Pf3D7_13_v3-2124602-2124876-1	2124602	2124876	2124635	2124847	274	213	AATTTGGTTTCAATAAAATTATCAGCTTTCTT	GAAGAATTTTAACACAAGGAGATCATCAC
Pf3D7_13_v3-2479055-2479275-1	2479055	2479275	2479087	2479246	220	160	CTTATAAAGAGAAATTTTCATGTTAGCGCTT	AGTCTTCCTTGATTTCTTTATCCAAGGTA
Pf3D7_13_v3-2481079-2481321-1	2481079	2481321	2481107	2481288	242	182	AGAAGATAAGCAATTATGGCAAAAGGT	TCCATTTAAATAATAACCTTTGATCACTTTGAT
Pf3D7_13_v3-2669104-2669339-1	2669104	2669339	2669136	2669307	235	172	ATTTACATGATGTAACTGAATCTCAGCTTTT	AGCCAGTATTCTTTTTATGAAGTATTTTAACA
Pf3D7_14_v3-39920-40170-1	39920	40170	39954	40137	250	184	CCAACTATATCTGTTCCATAAATGGTTATATTT	ATTTATTTGGATTGAGATCTTAATGTTCAAAGT
Pf3D7_14_v3-120188-120381-1	120188	120381	120216	120351	193	136	GTCCTTATCACATCCTCCATTGTTTAC	ACAGAAAGAATGGTTTAGAAATGTACGAAT
Pf3D7_14_v3-150075-150318-1	150075	150318	150106	150294	243	189	CCGAAAATAGAACTCCATATGTTCATTACC	GTCTGGAACGAGAAGATGTCTTTG
Pf3D7_14_v3-279635-279818-1	279635	279818	279664	279786	183	123	CGGATAAATGTTTAGTTATTAGCCAGGT	CATTACTTATGGGAAGTTTCGGTAATTTCATA
Pf3D7_14_v3-407346-407604-1	407346	407604	407380	407571	258	192	TCGTCTTTCTGTTCATTATCCATATAATCTTTT	TGAACTCTTTAAATTATCCTTTTTGAATATCCA
Pf3D7_14_v3-564177-564409-1	564177	564409	564209	564377	232	169	AAAATCTTTTGGTATTGTATTTTGACTGCAC	AAACGGAATCACTTATGGATACCATTTTATTT
Pf3D7_14_v3-1038340-1038518-1	1038340	1038518	1038370	1038486	178	117	ACACTTCAACTACACTTTTTAATTTAGCC	AGATCTTATGTTAAACTTCTAGAAGATGAAGT
Pf3D7_14_v3-1956096-1956312-1	1956096	1956312	1956130	1956286	216	157	TTTTTCTCCACTTTGTAATTTTTATTGTTGAAT	CGGGTGGTATCATGAGAATAGTTGAT
Pf3D7_14_v3-1992261-1992458-1	1992261	1992458	1992290	1992426	197	137	TTTTACTTTTGCTACCATCAGGCATAAT	ATCTTATTATGAAAGCTGTACATCCGATTTTA
Pf3D7_14_v3-2524931-2525119-1	2524931	2525119	2524963	2525089	188	127	ATGATCTTCTCTGAAATTTACTTGAATTGTT	ACCAAACTTTTGGAGATTTCAAGATTATGA
Pf3D7_14_v3-3124614-3124870-1	3124614	3124870	3124643	3124842	256	200	CAGATTATTTGGTAATGAACAACCAGGA	AGGTCTTCCTAATCTTGAACCATCATAT
Pf3D7_14_v3-3214318-3214502-1	3214318	3214502	3214352	3214478	184	127	TGTTAAAATATTTTCCAAAGAATTCAATTAGCG	TCAATTGATGGTTGCCTTTCGATT
